|------------------------------|
|..............................|
|..............................|
|..............................|
|..............................|
|...........--------...........|
|..............................|
|..............................|
|..............................|
|..............................|
|--------..............--------|
|...............H..............|
|..............................|
|..............................|
|..............................|
|..............................|
|..............................|
|..............................|
|..............................|
|......------------------......|
|------------------------------|