|------------------------------|
|..............................|
|..............................|
|..............................|
|..............H...............|
|...........--------...........|
|..............................|
|..............................|
|..............................|
|...A......................A...|
|--------..............--------|
|..............................|
|..............................|
|..............................|
|..............................|
|..............................|
|..............................|
|..............................|
|...............A..............|
|......------------------......|
|------------------------------|